

NO ./textures/north.png
SO ./textures/south.png
WE ./textures/west.png
EA ./textures/east.png
F 204,136,0
C 153,204,255

        1111111111111111111111111
        1000000000110000000000001
        1011000001110000000000001
        1001000000000000000000001
111111111011000001110000000000001
100000000011000001110111111111111
11110111111111011100000010001
11110111111 11011101010010001
11000000110101011100000010001
10000000000000001100000010001
100000000000000011010100N0001
110000011101010111110100000011
11110111 1110101 101111010001
11111111 1111111 111111111111
